11111111
100C0001
10P0E001
1C000001
11111111